165 165 165 165 165 165 165 165 165 165 165 165 165 165 165 165 165 165 165 165 165 165 165 165 165 165 165 165 165 165 165 165 165 165 165 165 165 165 165 165 165 165 165 165 165 165 165 165 165 165 
165 165 165 165 165 165 165 165 165 165 165 165 165 165 165 165 165 165 165 165 165 165 165 165 165 165 165 165 165 165 165 165 165 165 165 165 165 165 165 165 165 165 165 165 165 165 165 165 165 165 
165 165 165 165 98 99 90 91 165 165 165 165 165 165 165 165 165 165 165 165 165 165 165 165 165 165 165 165 165 165 165 165 165 165 177 12 12 12 12 12 12 12 12 12 12 12 12 12 12 12 
165 165 165 165 100 101 92 93 165 165 165 165 165 165 165 165 165 165 165 165 165 165 165 165 165 165 165 165 165 165 165 165 165 165 177 12 125 125 12 145 145 12 145 145 12 145 12 12 145 12 
165 165 165 154 173 173 153 165 165 165 165 165 165 165 165 165 165 165 165 165 165 165 165 165 165 165 165 165 165 165 165 165 165 165 177 125 12 125 125 145 145 145 145 145 145 145 145 145 12 145 
165 165 165 154 173 173 153 165 165 165 165 165 165 165 165 165 165 165 165 165 165 165 165 165 165 165 165 165 165 165 165 165 165 165 6 6 6 6 12 12 12 12 12 12 145 145 12 145 12 12 
165 165 165 157 173 173 155 156 156 156 156 156 156 156 156 156 156 156 156 156 156 156 156 156 156 156 156 156 156 156 156 156 156 156 6 165 165 6 12 145 145 12 12 145 145 12 12 145 145 12 
165 165 154 173 173 173 173 173 173 173 173 173 173 173 173 173 173 173 173 173 173 173 173 173 173 173 173 173 173 173 173 173 173 173 173 179 165 6 12 145 145 145 145 145 12 12 12 145 145 12 
165 165 154 173 173 173 173 173 173 173 173 173 173 173 173 173 173 173 173 173 173 178 152 152 152 152 152 152 152 152 152 152 152 152 6 165 165 6 12 145 12 145 145 12 12 145 12 12 145 145 
165 165 154 173 173 151 152 152 152 152 152 152 152 152 152 152 152 152 152 158 173 178 165 165 165 165 165 165 5 165 165 165 165 165 6 6 6 6 12 12 12 145 12 12 145 12 12 12 12 145 
165 165 154 173 173 153 165 165 165 165 165 165 165 165 165 165 165 165 165 154 173 178 165 165 5 165 165 165 165 165 165 165 5 165 177 145 12 12 12 145 145 145 12 145 12 145 12 145 145 12 
165 165 154 173 173 153 165 165 165 165 165 165 165 165 165 165 165 165 165 154 173 178 165 165 165 165 29 30 33 34 147 148 165 165 177 145 145 145 145 145 12 12 12 12 12 12 12 12 145 12 
165 165 154 173 173 153 165 165 165 165 165 165 165 165 165 165 165 165 165 154 173 178 165 165 165 5 31 32 35 36 149 150 165 165 174 12 12 12 12 12 12 12 12 12 12 12 12 12 12 12 
165 165 154 173 173 153 165 165 165 165 165 165 165 165 165 165 165 165 165 154 181 178 165 165 165 165 165 154 179 173 153 165 165 165 165 165 165 165 165 165 165 165 165 165 165 165 165 165 165 165 
165 165 154 173 173 153 165 165 165 165 165 165 165 165 165 165 165 165 165 154 173 155 156 156 156 156 156 157 173 173 153 165 165 165 165 165 165 165 165 165 165 165 165 165 165 165 165 165 165 165 
165 165 154 173 173 153 165 165 165 165 165 165 165 165 165 165 165 165 165 154 173 173 173 173 173 173 173 173 173 173 153 165 165 165 165 165 165 165 165 165 165 165 165 165 165 165 165 165 165 165 
165 165 154 173 173 153 165 165 165 165 165 165 165 165 165 165 165 165 165 165 174 173 173 173 173 173 173 173 173 176 165 165 165 165 165 165 165 165 165 165 165 165 165 165 165 165 165 165 165 165 
165 165 154 173 173 153 165 165 165 165 165 165 165 165 165 165 165 165 165 165 154 173 151 152 152 152 152 152 152 165 165 165 165 165 165 165 165 165 165 165 165 165 165 165 165 165 165 165 165 165 
165 165 154 173 173 153 165 165 165 165 165 165 165 165 165 165 165 165 165 165 154 173 153 165 165 165 165 165 165 165 165 165 165 165 165 165 165 165 165 165 165 165 165 165 165 165 165 165 165 165 
165 165 154 173 173 153 165 165 165 165 5 165 165 165 165 165 165 165 165 165 154 173 153 165 165 165 165 165 165 165 165 165 165 165 165 165 165 165 165 165 165 165 165 165 165 165 165 165 165 165 
165 165 154 173 173 153 165 165 165 165 165 165 165 165 165 165 165 165 165 165 154 173 153 165 165 165 165 165 165 165 165 165 165 165 165 165 165 165 165 165 165 165 165 165 165 165 165 165 165 165 
165 165 154 173 173 153 165 5 165 165 165 165 5 165 165 165 165 165 165 165 154 173 153 165 165 165 165 165 165 165 165 165 165 165 165 165 165 165 165 165 165 165 165 165 165 165 165 165 165 165 
165 165 154 173 173 153 165 165 165 165 5 165 165 165 165 165 165 165 165 165 154 173 153 165 165 165 165 165 165 165 165 165 165 165 165 165 165 165 165 165 165 165 165 165 165 165 165 165 165 165 
165 165 154 173 173 153 165 94 95 86 87 165 165 165 165 165 165 165 165 165 154 180 153 165 165 165 165 165 165 165 165 165 165 165 165 165 165 165 165 165 165 165 165 165 165 165 165 165 165 165 
165 165 154 173 173 153 165 96 97 88 89 165 165 165 165 165 165 165 165 165 154 173 155 156 156 156 156 156 156 156 156 156 156 165 165 165 165 165 165 165 165 165 165 165 165 165 165 165 165 165 
165 165 154 173 173 153 154 173 179 5 165 165 165 165 165 165 165 165 165 165 154 173 173 173 173 173 173 173 173 173 173 173 173 153 165 165 165 165 165 165 165 165 165 165 165 165 165 165 165 165 
165 165 154 173 173 155 157 173 153 165 165 5 165 165 165 165 165 165 165 165 154 173 173 173 173 173 173 173 173 173 173 173 173 153 165 165 165 165 165 165 165 165 165 165 165 165 165 165 165 165 
165 165 154 173 173 173 173 180 153 165 165 165 165 165 165 165 165 165 165 165 154 173 151 152 158 173 151 152 152 152 152 158 173 153 165 165 165 165 165 165 165 165 165 165 165 165 165 165 165 165 
165 165 154 173 173 173 173 173 155 165 165 165 165 165 165 165 165 165 165 165 154 173 153 165 154 173 153 9 165 165 5 154 173 153 165 165 165 165 165 165 165 165 165 165 165 165 165 165 165 165 
165 165 165 152 152 152 158 173 173 153 165 165 165 165 165 165 165 165 165 165 154 173 153 9 157 173 155 179 155 165 165 154 173 153 165 165 165 165 165 165 165 165 165 165 165 165 165 165 165 165 
165 165 165 165 165 165 154 173 173 153 165 165 165 165 165 165 165 165 165 165 154 173 153 173 173 173 173 173 178 165 9 154 173 153 165 165 165 165 165 165 165 165 165 165 165 165 165 165 165 165 
165 165 165 165 165 165 154 173 173 153 165 165 165 165 165 165 165 165 165 165 154 173 153 152 152 9 158 175 176 154 173 157 173 153 165 165 165 165 165 165 165 165 165 165 165 165 165 165 165 165 
165 165 165 165 165 165 154 173 173 153 165 165 165 165 165 165 165 165 165 165 165 9 165 165 154 173 153 165 165 165 174 173 173 153 165 5 165 165 165 165 165 165 165 165 165 165 165 165 165 165 
165 165 165 165 165 165 154 173 173 153 165 165 165 165 165 165 165 165 165 165 154 173 156 156 157 173 155 156 156 156 156 157 173 153 165 165 165 165 165 165 165 165 165 165 165 165 165 165 165 165 
165 165 165 165 165 165 154 173 173 153 165 165 165 165 165 165 165 165 165 165 154 173 173 173 173 173 173 173 173 173 173 173 173 153 165 165 165 165 165 165 165 165 165 165 165 165 165 165 165 165 
165 165 165 165 165 165 154 173 173 153 165 165 165 165 165 165 165 165 165 165 165 152 152 152 152 152 152 152 152 152 158 173 151 165 165 165 165 5 165 165 165 5 165 165 165 165 165 165 165 165 
165 165 165 165 165 165 154 173 173 155 156 156 156 156 156 156 156 156 165 165 165 165 165 165 165 165 165 165 165 165 154 173 153 165 165 165 165 165 165 165 165 165 165 165 165 165 165 5 165 165 
165 165 165 165 165 165 154 173 173 173 173 173 173 173 173 173 173 173 153 165 165 165 165 165 165 165 165 165 165 165 154 173 153 165 165 165 165 165 165 165 165 165 165 165 165 165 165 165 165 165 
165 165 165 5 165 165 154 173 173 173 173 173 173 173 173 173 173 173 155 165 165 165 165 165 165 165 165 165 165 165 154 173 153 165 165 5 165 165 25 26 21 22 165 165 165 165 165 165 165 165 
156 156 156 156 156 156 157 173 151 152 152 152 152 152 152 152 158 173 173 153 165 165 165 165 165 165 165 165 165 165 154 173 153 165 165 165 165 165 27 28 23 24 165 165 165 165 165 165 165 165 
173 173 173 173 173 173 173 173 153 165 165 165 165 165 165 165 154 173 173 153 165 165 165 165 165 165 165 165 165 165 154 173 153 165 165 165 165 165 165 154 173 4 153 165 5 165 165 165 165 165 
173 173 173 173 173 173 173 173 153 165 5 165 165 165 165 165 154 173 173 155 156 156 156 156 156 156 156 156 165 165 154 173 153 165 165 165 5 165 165 154 173 173 153 165 165 165 165 165 165 165 
173 151 152 152 152 152 152 5 165 165 165 165 165 165 165 165 154 173 173 173 173 173 173 173 173 173 173 173 155 156 157 173 155 156 156 156 156 156 156 157 173 173 153 165 5 165 165 165 165 165 
173 153 165 17 18 165 165 165 165 165 165 5 165 165 165 165 154 173 173 173 173 173 173 173 173 173 173 173 173 173 173 180 173 173 173 173 173 173 173 173 173 173 153 165 165 165 165 165 165 165 
173 153 165 19 20 165 165 165 5 165 5 165 165 165 165 165 165 152 152 152 152 152 152 152 152 152 152 152 152 152 152 152 152 152 152 152 152 152 152 152 152 152 165 165 165 165 165 165 165 165 
173 155 5 157 179 153 165 165 165 165 165 165 165 165 165 165 165 165 165 165 165 165 165 165 165 165 165 165 165 165 165 165 165 165 165 165 165 165 165 165 165 165 165 165 165 165 165 165 165 165 
180 173 173 173 173 153 5 165 165 165 165 165 165 165 165 165 165 165 165 165 165 165 165 165 165 165 165 165 165 165 165 165 165 165 165 165 165 165 165 165 165 165 165 165 165 165 165 165 165 165 
173 173 173 173 173 153 165 165 165 165 165 165 165 165 165 165 165 165 165 165 165 165 165 165 165 165 165 165 165 165 165 165 165 165 165 165 165 165 165 165 165 165 165 165 165 165 165 165 165 165 
5 165 165 165 5 165 165 165 165 165 165 165 165 165 165 165 165 165 165 165 165 165 165 165 165 165 165 165 165 165 165 165 165 165 165 165 165 165 165 165 165 165 165 165 165 165 165 165 165 165 
165 165 165 165 165 165 165 165 165 165 165 165 165 165 165 165 165 165 165 165 165 165 165 165 165 165 165 165 165 165 165 165 165 165 165 165 165 165 165 165 165 165 165 165 165 165 165 165 165 165 
