165 165 5 165 165 165 165 5 165 165 165 165 165 5 165 165 166 166 166 166 166 166 166 166 166 166 166 166 166 5 166 166 166 166 166 166 166 5 165 165 165 166 166 166 166 166 166 166 166 166 
5 165 165 165 165 5 165 165 165 165 5 165 165 165 165 165 166 166 166 166 166 166 166 166 166 166 166 166 166 166 166 166 166 5 166 9 166 166 165 9 165 166 166 166 166 166 166 166 166 166 
94 95 86 87 5 165 94 95 165 94 95 165 165 165 5 165 166 166 166 166 166 166 166 166 166 166 166 166 165 165 165 165 165 165 166 179 166 166 165 165 165 166 166 166 166 166 166 166 166 166 
96 97 88 89 165 165 96 97 165 96 97 165 165 5 165 165 166 166 166 166 166 166 166 166 166 166 166 166 165 9 165 165 9 165 166 165 166 165 9 165 166 166 166 166 166 166 166 166 166 166 
165 165 165 165 165 165 165 165 165 177 178 165 165 165 165 165 166 166 166 166 166 166 166 166 166 166 166 166 165 165 5 165 165 165 166 165 165 165 165 165 166 5 166 166 166 166 166 166 166 166 
165 165 165 165 165 5 165 165 165 177 178 165 165 165 165 165 166 166 166 166 166 166 166 166 166 166 166 166 166 165 165 165 165 166 166 5 165 9 165 165 166 166 166 166 166 166 166 166 166 166 
165 165 165 165 165 165 165 165 165 177 178 165 165 165 165 165 166 166 166 166 166 166 166 166 166 166 166 166 166 165 9 165 5 166 166 166 165 165 165 165 166 166 166 166 166 166 166 166 166 166 
165 165 165 165 165 165 165 165 165 177 178 165 5 165 165 165 166 166 166 166 166 166 166 166 166 166 166 166 166 165 165 165 166 166 166 166 166 165 5 165 166 166 166 166 166 166 166 166 166 166 
165 165 165 165 165 165 165 165 165 177 178 165 165 165 165 165 166 166 166 166 166 166 166 166 166 166 166 166 166 165 165 166 166 166 166 166 166 165 166 165 166 166 166 166 166 166 166 166 166 166 
166 166 166 166 166 166 166 166 165 177 178 166 166 166 166 166 166 166 166 166 166 166 166 166 166 166 166 166 166 165 165 166 166 166 166 166 166 165 166 165 166 166 166 166 166 166 166 166 166 166 
166 166 166 166 166 166 166 166 165 177 178 166 166 166 166 166 166 166 90 91 166 166 166 166 166 166 166 166 166 166 173 166 166 166 166 166 166 173 166 173 166 166 166 166 166 166 166 166 166 166 
166 166 166 166 166 173 173 173 173 177 173 173 173 173 173 173 173 173 92 93 173 173 173 173 173 173 173 173 173 173 173 173 173 173 173 173 173 173 173 173 173 173 173 90 91 166 166 166 166 166 
166 166 166 166 166 173 178 175 175 174 173 173 173 173 173 173 173 173 173 173 173 173 173 173 173 173 173 173 173 173 173 173 173 173 173 173 173 173 173 173 173 173 173 92 93 166 166 166 166 166 
166 166 166 166 166 173 178 166 166 166 166 166 166 166 166 166 166 166 166 166 166 166 166 166 166 166 166 166 166 166 166 173 173 166 166 166 166 166 166 166 166 166 166 166 166 166 166 166 166 166 
166 166 166 166 166 173 178 166 166 166 166 166 166 166 166 166 166 166 166 166 166 166 166 166 166 166 166 166 166 166 166 173 173 166 166 166 166 166 166 166 166 166 166 166 166 166 166 166 166 166 
166 166 166 166 166 173 178 166 166 166 166 166 166 166 166 166 166 166 166 166 166 166 166 166 166 166 166 166 166 166 166 173 173 166 166 166 166 166 166 166 166 166 166 166 166 166 166 166 166 166 
166 166 166 166 166 173 178 166 166 166 166 166 166 166 166 166 166 166 166 166 166 166 166 166 166 166 166 166 166 166 166 173 173 166 166 166 166 166 166 166 166 166 166 166 166 166 166 166 166 166 
166 166 166 166 166 173 178 166 166 166 166 166 166 166 166 166 166 166 166 166 166 166 166 166 166 166 166 166 166 166 166 173 173 166 166 166 166 166 166 166 166 166 166 166 166 166 166 166 166 166 
166 166 166 166 166 173 178 166 166 172 50 102 102 50 108 166 166 166 166 166 166 166 166 166 166 166 166 166 166 166 166 173 173 166 166 166 166 166 166 166 166 166 166 166 166 166 166 166 166 166 
166 166 166 166 166 173 178 166 166 172 112 102 102 102 108 166 166 166 166 166 166 166 166 166 166 166 166 166 166 166 166 173 173 166 166 166 166 166 166 166 166 166 166 166 166 166 166 166 166 166 
166 166 166 166 166 173 178 166 166 172 112 98 99 112 108 166 166 166 166 166 166 166 166 166 166 166 166 166 166 166 166 173 173 166 166 166 166 166 165 165 165 165 165 165 166 166 166 166 166 166 
166 166 166 166 166 173 178 166 166 165 165 100 101 165 165 166 166 166 166 166 166 166 166 166 166 166 166 166 166 166 166 173 173 166 166 166 165 165 165 165 165 165 165 165 165 166 166 166 166 166 
166 166 166 166 166 173 178 166 166 165 165 173 179 165 165 166 166 166 166 166 166 166 166 166 166 166 166 166 166 166 166 173 173 165 165 165 165 165 58 59 62 63 165 165 165 166 166 166 166 166 
166 166 166 166 166 173 178 166 166 165 173 173 173 173 165 166 166 166 166 166 166 166 166 166 166 166 166 166 166 166 166 173 173 165 165 165 165 165 60 61 64 65 165 165 165 166 166 166 166 166 
166 166 166 166 166 173 178 166 166 166 177 173 173 166 166 166 166 166 166 166 166 166 166 166 166 166 166 166 166 166 166 173 173 165 165 165 165 165 54 55 66 67 165 165 165 166 166 166 166 166 
166 166 166 166 166 173 178 166 166 166 166 173 173 166 166 166 166 166 166 166 166 166 166 166 166 166 166 166 166 166 166 173 173 165 165 165 165 165 56 57 68 69 165 165 165 166 166 166 166 166 
166 166 166 166 166 173 173 173 173 173 173 173 173 173 173 173 173 173 173 173 173 166 166 166 166 166 166 166 166 166 166 173 173 165 165 165 165 165 173 179 165 165 165 165 165 166 166 166 166 166 
85 85 85 85 5 166 166 166 166 166 166 173 173 166 166 166 166 166 166 173 173 166 166 166 166 166 166 166 166 166 166 173 173 155 156 156 156 157 173 165 165 165 165 165 165 166 166 166 166 166 
5 17 18 85 85 166 166 166 166 166 166 173 173 166 166 166 166 166 166 173 173 166 166 166 166 166 166 166 166 166 166 173 173 173 173 173 173 173 173 165 165 165 165 165 166 166 166 166 166 166 
5 19 20 85 85 166 166 166 166 166 166 173 173 166 166 166 166 166 166 173 173 166 166 166 166 166 166 166 166 166 177 173 173 173 173 173 173 173 173 165 165 165 165 165 166 166 166 166 166 166 
85 173 179 85 85 166 166 166 166 166 166 173 173 166 166 166 166 166 166 173 173 166 166 166 166 166 166 166 166 166 173 173 166 166 166 166 166 166 166 166 166 166 166 166 166 166 166 166 166 166 
177 173 173 178 5 166 166 166 166 166 166 173 173 166 166 166 166 166 166 173 173 166 166 166 166 166 166 166 166 166 173 173 166 166 166 166 166 166 166 166 166 166 166 166 166 166 166 166 166 166 
177 173 173 178 166 166 86 87 166 166 166 173 173 166 166 166 166 166 166 173 173 166 166 166 166 166 166 166 166 166 173 173 166 166 166 166 166 166 166 166 166 166 166 166 166 166 166 166 166 166 
177 173 173 173 173 173 88 89 173 173 173 173 173 166 166 166 166 166 166 173 173 166 166 166 166 166 166 166 166 166 173 173 166 166 166 166 166 166 166 166 166 166 166 166 166 166 166 166 166 166 
177 173 173 173 173 173 173 173 173 173 173 173 173 166 166 166 166 166 166 173 173 166 166 166 166 166 166 166 166 166 173 173 166 166 166 166 166 166 166 166 166 166 166 166 166 166 166 166 166 166 
174 175 175 175 175 175 165 165 165 166 166 166 166 166 166 166 166 166 166 173 173 166 166 166 166 166 166 166 166 166 173 173 166 166 166 166 166 166 166 166 166 166 166 166 166 166 166 166 166 166 
165 165 165 165 165 165 165 165 165 166 166 166 166 166 166 166 166 166 166 173 173 166 166 166 166 166 166 166 166 166 173 173 166 166 166 166 166 166 166 166 166 166 166 166 166 166 166 166 166 166 
166 166 166 166 166 166 166 166 166 166 166 166 166 166 166 166 166 166 166 173 173 166 166 166 166 166 166 166 166 166 173 173 166 166 166 166 166 166 166 166 166 166 166 166 166 166 166 166 166 166 
166 166 166 166 166 166 166 166 166 166 166 166 166 166 166 166 166 166 166 173 173 166 166 166 166 166 166 166 166 166 173 173 166 166 166 166 166 166 166 166 166 166 166 166 166 166 166 166 166 166 
166 166 166 166 166 166 166 166 166 166 166 166 166 166 166 166 166 166 166 173 173 166 166 166 166 166 166 166 166 166 173 173 166 166 166 166 166 166 166 166 166 166 166 166 166 166 166 166 166 166 
166 166 166 166 166 166 166 166 166 166 166 166 166 166 166 166 166 166 166 173 173 166 166 166 166 166 166 166 166 166 173 178 166 166 166 166 166 166 166 166 166 166 166 166 166 166 166 166 166 166 
166 166 166 166 166 166 166 166 166 166 166 166 166 166 166 166 166 166 166 173 173 166 166 166 166 166 166 166 166 166 173 166 171 171 171 171 172 108 103 107 108 109 110 108 107 3 3 3 3 3 
166 166 166 166 166 166 166 166 166 166 166 166 166 166 166 166 166 166 166 173 173 166 166 166 166 166 166 166 166 166 173 169 165 165 165 37 38 111 112 107 111 107 112 113 114 37 38 165 152 158 
166 166 166 166 166 166 166 166 166 166 166 166 166 166 166 166 166 166 166 173 173 173 173 173 173 173 173 173 173 173 173 168 165 165 165 39 40 108 108 108 108 108 108 108 108 39 40 41 165 154 
166 166 166 166 166 166 166 166 166 166 166 166 166 166 166 166 166 166 166 173 173 173 173 173 173 173 173 173 173 173 173 168 165 165 165 165 165 111 46 47 70 71 51 50 107 165 165 165 165 154 
166 166 166 166 166 166 166 166 166 166 166 166 166 166 166 166 166 166 166 166 166 166 166 166 166 166 166 166 166 166 173 168 165 165 165 5 165 5 46 49 72 73 53 50 5 165 165 5 165 154 
166 166 166 166 166 166 166 166 166 166 166 166 166 166 166 166 166 166 166 166 166 166 166 166 166 166 166 166 166 166 173 168 165 165 165 165 165 5 48 49 72 73 53 52 5 5 165 165 165 154 
166 166 166 166 166 166 166 166 166 166 166 166 166 166 166 166 166 166 166 166 166 166 166 166 166 166 166 166 166 166 173 168 165 165 165 5 165 5 74 75 82 83 79 78 5 165 165 5 165 154 
166 166 166 166 166 166 166 166 166 166 166 166 166 166 166 166 166 166 166 166 166 166 166 166 166 166 166 166 166 166 173 173 173 173 173 173 173 173 173 81 164 85 80 85 84 165 165 165 165 154 
166 166 166 166 166 166 166 166 166 166 166 166 166 166 166 166 166 166 166 166 166 166 166 166 166 166 166 166 166 166 166 169 165 165 5 165 165 84 80 81 81 84 85 85 81 165 165 165 5 157 
