1 1 28 49 49 49 48 48 49 48 49 49 49 49 49 49 49 49 52 49 49 49 49 49 49 49 49 52 49 49 49 50 49 49 49 49 49 49 49 49 49 49 50 49 49 49 49 49 49 49 50 49 49 49 49 49 49 49 49 51 49 51 49 49 49 49 49 49 49 49 49 49 53 49 49 49 49 49 49 49 53 49 8 49 49 52 49 49 49 49 49 49 53 49 49 49 49 49 53 49 
1 1 30 48 30 49 48 49 49 48 49 48 49 49 49 52 49 49 49 49 49 49 52 49 49 50 49 49 49 49 49 52 49 49 49 50 49 49 49 49 49 49 49 49 49 49 49 49 51 49 49 49 51 49 49 50 49 49 49 49 49 51 49 51 49 51 49 49 51 49 53 49 53 49 49 53 49 49 49 53 49 53 8 49 49 49 49 49 53 49 49 49 49 53 53 49 49 49 49 49 
1 1 30 30 28 49 49 49 50 49 49 49 50 49 49 49 49 49 49 49 49 49 49 49 49 49 49 49 49 49 49 49 49 49 49 49 49 49 49 50 49 49 49 49 49 49 49 49 49 49 49 49 49 49 49 49 49 49 49 49 49 49 49 49 49 49 49 49 49 49 49 49 49 49 49 49 49 49 49 49 49 49 8 49 49 49 53 49 49 49 49 52 49 49 49 49 53 49 49 53 
30 47 30 10 10 10 10 46 10 10 10 10 10 10 10 10 10 10 10 10 10 10 10 10 10 10 10 10 10 10 10 10 10 10 10 10 10 10 10 10 10 10 10 10 10 10 10 45 10 10 10 10 10 10 10 10 10 10 10 10 10 10 10 46 10 10 10 10 10 10 10 10 10 10 10 10 10 10 10 10 10 10 8 0 0 0 0 0 0 0 0 0 0 0 0 0 0 0 0 0 
30 1 30 10 10 10 10 10 10 10 10 45 10 10 10 10 10 10 10 10 10 10 10 10 10 10 45 10 10 10 10 10 10 10 10 10 10 10 10 10 10 46 10 10 10 10 10 10 10 10 10 10 10 10 10 10 10 45 10 10 10 10 10 10 10 10 10 10 10 10 10 10 10 10 10 10 10 10 10 10 10 8 8 0 0 0 0 0 0 0 0 0 0 0 0 0 0 0 0 0 
30 30 48 30 5 30 30 30 30 30 30 30 30 52 52 8 5 3 3 3 3 3 3 3 3 3 3 3 3 0 0 0 0 0 8 8 0 0 0 0 0 0 0 0 0 0 0 0 0 0 0 0 0 0 0 0 0 8 8 0 0 0 0 0 0 0 0 0 0 0 0 0 0 0 0 0 0 0 0 0 0 8 8 0 0 0 0 0 0 0 0 0 0 0 0 0 0 0 0 0 
47 5 30 30 51 9 47 30 1 30 1 30 30 1 30 8 5 5 5 5 5 5 5 30 30 30 30 5 5 0 0 0 0 0 8 8 0 0 0 0 0 0 0 0 0 0 0 0 0 0 0 0 0 0 0 0 0 8 8 0 0 0 0 0 0 0 0 0 0 0 0 0 0 0 0 0 0 0 0 0 0 8 8 0 0 0 0 0 0 0 0 0 0 0 0 0 0 0 0 0 
5 30 30 47 30 9 30 47 30 30 9 30 1 30 30 8 5 30 30 30 30 30 30 30 30 30 30 30 30 0 0 0 0 0 8 8 0 0 0 0 0 0 0 0 0 0 0 0 0 0 0 0 0 0 0 0 0 8 8 0 0 0 0 0 0 0 0 0 0 0 0 0 0 0 0 0 0 0 0 0 0 8 8 0 0 0 0 0 0 0 0 0 0 0 0 0 0 0 0 0 
30 30 30 30 30 30 47 30 47 30 30 1 30 30 30 8 5 5 30 30 30 30 30 30 30 30 30 30 30 0 0 0 0 0 8 8 0 0 0 0 0 0 0 0 0 0 0 0 0 0 0 0 0 0 0 0 0 8 8 0 0 0 0 0 0 0 0 0 0 0 0 0 0 0 0 0 0 0 0 0 0 8 8 0 0 0 0 0 0 0 0 0 0 0 0 0 0 0 0 0 
0 0 0 0 0 0 0 0 0 0 0 0 0 0 0 8 5 5 0 0 0 0 0 0 0 0 0 0 0 0 0 0 0 0 8 8 0 0 0 0 0 0 0 0 0 0 0 0 0 0 0 0 0 0 0 0 0 8 8 0 0 0 0 0 0 0 0 0 0 0 0 0 0 0 0 0 0 0 0 0 0 8 8 0 0 0 0 0 0 0 0 0 0 0 0 0 0 0 0 0 
0 0 0 0 0 0 0 0 0 0 0 0 0 0 5 8 5 0 0 0 0 0 0 0 0 0 0 0 0 0 0 0 0 0 8 8 0 0 0 0 0 0 0 0 0 0 0 0 0 0 0 0 0 0 0 0 0 8 46 0 0 0 0 0 0 0 0 0 0 0 0 0 0 0 0 0 0 0 0 0 0 8 8 0 0 0 0 0 0 0 0 0 0 0 0 0 0 0 0 0 
0 0 0 0 0 0 0 0 0 0 0 0 0 0 0 8 5 0 0 0 0 0 0 0 0 0 0 0 0 0 0 0 0 0 8 8 0 0 0 0 0 0 0 0 0 0 0 0 0 0 0 0 0 0 0 0 0 8 8 0 0 0 0 0 0 0 0 0 0 0 0 0 0 0 0 0 0 0 0 0 0 8 8 0 0 0 0 0 0 0 0 0 0 0 0 0 0 0 0 0 
0 0 0 0 0 0 0 0 0 0 0 0 0 0 0 8 5 0 0 0 0 0 0 3 3 3 3 3 3 0 0 0 0 0 8 8 0 0 0 0 0 0 0 0 0 0 0 0 0 0 0 0 0 0 0 0 0 8 8 0 0 0 0 0 0 0 0 0 0 0 0 0 0 0 0 0 0 0 0 0 0 8 8 0 0 0 0 0 0 0 0 0 0 0 0 0 0 0 0 0 
0 0 0 0 0 0 0 0 0 0 0 0 0 0 5 8 5 0 0 0 3 0 3 0 0 0 0 3 0 0 0 0 0 0 8 8 0 0 0 0 0 0 0 0 0 0 0 0 0 0 0 0 0 0 0 0 0 8 8 0 0 0 0 0 0 0 0 0 0 0 0 0 0 0 0 0 0 0 0 0 0 8 8 0 0 0 0 0 0 0 0 0 0 0 0 0 0 0 0 0 
0 0 0 0 0 0 0 0 0 0 0 0 0 0 0 8 10 10 10 10 10 10 10 10 10 45 10 10 10 10 10 10 10 10 8 8 10 10 10 10 10 10 10 10 10 10 10 10 10 10 10 10 10 8 0 0 0 8 8 0 0 0 0 0 0 0 0 0 0 0 0 0 0 0 0 0 0 0 0 0 0 8 8 0 0 0 0 0 0 0 0 0 0 0 0 0 0 0 0 0 
0 0 0 0 0 0 0 0 0 0 0 0 0 0 0 8 5 0 0 0 0 0 0 0 0 0 0 0 0 0 0 0 0 0 8 8 0 0 0 0 0 0 0 0 0 0 0 0 0 0 0 0 8 8 0 0 0 45 8 0 0 0 0 0 0 0 0 0 0 0 0 0 0 0 0 0 0 0 0 0 0 8 8 0 0 0 0 0 0 0 0 0 0 0 0 0 0 0 0 0 
0 0 0 0 0 0 0 0 0 0 0 0 0 0 5 8 5 0 0 0 0 0 0 0 0 0 0 0 0 0 0 0 0 0 8 8 0 0 0 0 0 0 0 0 0 0 0 0 0 0 0 0 8 8 0 0 0 8 8 0 0 0 0 0 0 0 0 0 0 0 0 0 0 0 0 0 0 0 0 0 0 8 8 0 0 0 0 0 0 0 0 0 0 0 0 0 0 0 0 0 
0 0 0 0 0 0 0 0 0 0 0 0 0 0 5 8 5 0 0 0 0 0 0 0 0 0 0 0 0 0 0 0 0 0 8 8 0 0 0 0 0 0 0 0 0 0 0 0 0 0 0 0 8 8 0 0 0 8 8 0 0 0 0 0 0 0 0 0 0 0 0 0 0 0 0 0 0 0 0 0 0 8 8 0 0 0 0 0 0 0 0 0 0 0 0 0 0 0 0 0 
0 0 0 0 0 0 0 0 0 0 0 0 0 0 5 8 5 0 0 0 0 0 0 0 0 0 0 0 0 0 0 0 0 0 8 8 0 0 0 0 0 0 0 0 0 0 0 0 0 0 0 0 8 8 0 0 0 8 8 0 0 0 0 0 0 0 0 0 0 0 0 0 0 0 0 0 0 0 0 0 0 8 8 0 0 0 0 0 0 0 0 0 0 0 0 0 0 0 0 0 
0 0 0 0 0 0 0 0 0 0 0 0 0 0 0 8 5 0 0 0 0 0 0 0 0 0 0 0 0 0 0 0 0 0 8 8 0 0 0 0 0 0 0 0 0 0 0 0 0 0 0 0 8 8 0 0 0 8 8 0 0 0 0 0 0 0 0 0 0 0 0 0 0 0 0 0 0 0 0 0 0 8 8 0 0 0 0 0 0 0 0 0 0 0 0 0 0 0 0 0 
0 0 0 0 0 0 0 0 0 0 0 0 0 0 0 8 5 0 0 0 0 0 0 0 0 0 0 0 0 0 0 0 0 0 8 8 0 0 0 0 0 0 0 0 0 0 3 3 3 3 3 3 3 3 3 3 3 3 3 3 3 3 0 0 0 0 0 0 0 0 0 0 0 0 0 0 0 0 0 0 0 8 8 0 0 0 0 0 0 0 0 0 0 0 0 0 0 0 0 0 
0 0 0 0 0 0 0 0 0 0 0 0 0 0 0 8 5 5 0 0 0 0 0 0 0 0 0 0 0 0 0 0 0 0 8 8 0 0 0 0 0 0 0 0 0 0 3 3 3 3 3 3 3 3 3 3 3 3 3 3 3 3 0 0 0 0 0 0 0 0 0 0 0 0 0 0 0 0 0 0 0 8 8 0 0 0 0 0 0 0 0 0 0 0 0 0 0 0 0 0 
0 0 0 0 0 0 0 0 0 0 0 0 0 0 0 8 5 5 3 3 3 0 0 0 0 0 0 0 0 0 0 0 0 0 8 8 0 0 0 0 0 0 0 0 0 0 3 3 3 3 3 3 5 5 5 3 3 3 3 4 3 3 0 0 0 0 0 0 0 0 0 0 0 0 0 0 0 0 0 0 0 8 8 0 0 0 0 0 0 0 0 0 0 0 0 0 0 0 0 0 
0 0 0 0 0 0 0 0 0 0 0 3 3 0 0 8 0 3 3 3 3 0 0 0 0 0 0 0 0 0 0 0 0 0 8 8 0 0 0 0 0 0 0 0 0 0 3 3 0 3 3 5 32 33 62 5 3 3 3 3 3 3 0 0 0 0 0 0 0 0 0 0 0 0 0 0 0 0 0 0 0 8 8 0 0 0 0 0 0 0 0 0 0 0 0 0 0 0 0 0 
0 0 0 0 0 0 0 0 0 0 3 3 3 5 30 30 30 45 5 3 3 0 0 0 0 0 0 0 0 0 0 0 0 0 8 8 0 0 0 0 0 0 0 0 0 0 3 3 3 3 3 3 3 3 3 3 3 3 3 3 3 3 0 0 0 0 0 0 0 0 0 0 0 0 0 0 0 0 0 0 0 8 8 0 0 0 0 0 0 0 0 0 0 0 0 0 0 0 0 0 
0 0 0 0 0 0 0 0 0 0 3 3 3 5 30 19 18 30 5 3 3 0 0 0 0 0 0 0 0 0 0 0 0 0 8 8 0 0 0 0 0 0 0 0 0 0 3 3 3 3 3 3 3 3 3 3 3 3 3 5 3 7 0 0 0 0 0 0 0 0 0 0 0 0 0 0 0 0 0 0 0 8 8 0 0 0 0 0 0 0 0 0 0 0 0 0 0 0 0 0 
0 0 0 0 0 0 0 0 0 0 3 3 3 5 5 5 5 5 5 3 3 0 0 0 0 0 0 0 0 0 0 0 0 0 8 8 0 0 0 0 0 0 0 0 0 0 3 3 3 3 3 3 3 3 3 3 19 18 3 3 3 3 10 10 10 10 10 10 10 10 10 10 10 10 10 10 46 10 10 10 10 8 8 0 0 0 0 0 0 0 0 0 0 0 0 0 0 0 0 0 
0 0 0 0 0 0 0 0 0 0 3 3 3 0 0 0 0 0 3 3 3 0 0 0 0 0 0 0 0 0 0 0 0 0 8 8 0 0 0 0 0 0 0 0 0 0 3 3 3 3 4 3 3 3 3 3 3 3 5 3 7 3 10 10 10 10 10 10 10 45 10 10 10 10 10 10 10 10 10 10 10 8 8 0 0 0 0 0 0 0 0 0 0 0 0 0 0 0 0 0 
0 0 0 0 0 0 0 0 0 0 3 3 3 3 3 3 3 3 3 3 3 0 0 0 0 0 0 0 0 0 0 0 0 0 8 8 0 0 0 0 0 0 0 0 0 0 3 3 3 3 3 3 3 3 3 3 3 3 3 7 3 3 0 0 0 0 0 0 0 0 0 0 0 0 0 0 0 0 0 0 0 8 8 0 0 0 0 0 0 0 0 0 0 0 0 0 0 0 0 0 
0 0 0 0 0 0 0 0 0 0 0 0 0 0 0 8 8 0 0 0 0 0 0 0 0 0 0 0 0 0 0 0 0 0 8 8 0 0 0 0 0 0 0 0 0 0 0 0 0 0 0 0 8 8 0 0 0 0 0 0 0 0 0 0 0 0 0 0 0 0 0 0 0 0 0 0 0 0 0 0 0 8 8 0 0 0 0 0 0 0 0 0 0 0 0 0 0 0 0 0 
0 0 0 0 0 0 0 0 0 0 0 0 0 0 0 8 8 0 0 0 0 0 0 0 0 0 0 0 0 0 0 0 0 0 8 8 0 0 0 0 0 0 0 0 0 0 0 0 0 0 0 0 8 8 0 0 0 0 0 0 0 0 0 0 0 0 0 0 0 0 0 0 0 0 0 0 0 0 0 0 0 8 8 0 0 0 0 0 0 0 0 0 0 0 0 0 0 0 0 0 
0 0 0 0 0 0 0 0 0 0 0 0 0 0 0 8 8 0 0 0 0 0 0 0 0 0 0 0 0 0 0 0 0 0 8 8 0 0 0 0 0 0 0 0 0 0 0 0 0 0 0 0 8 8 0 0 0 0 0 0 0 0 0 0 0 0 0 0 0 0 0 0 0 0 0 0 0 0 0 0 0 8 8 0 0 0 0 0 0 0 0 0 0 0 0 0 0 0 0 0 
0 0 0 0 0 0 0 0 0 0 0 0 0 0 0 8 8 0 0 0 0 0 0 0 0 0 0 0 0 0 0 0 0 0 8 8 0 0 0 0 0 0 0 0 0 0 0 0 0 0 0 0 8 8 0 0 0 0 0 0 0 0 0 0 0 0 0 0 0 0 0 0 0 0 0 0 0 0 0 0 0 8 8 0 0 0 0 0 0 0 0 0 0 0 0 0 0 0 0 0 
0 0 0 0 0 0 0 0 0 0 0 0 0 0 0 8 8 0 0 0 0 0 0 0 0 0 0 0 0 0 0 0 0 0 8 8 0 0 0 0 0 0 0 0 0 0 0 0 0 0 0 0 8 8 0 0 0 0 0 0 0 0 0 0 0 0 0 0 0 0 0 0 0 0 0 0 0 0 0 0 0 8 8 0 0 0 0 0 0 0 0 0 0 0 0 0 0 0 0 0 
0 0 0 0 0 0 0 0 0 0 0 0 0 0 0 8 8 0 0 0 0 0 0 0 0 0 0 0 0 0 0 0 0 0 8 8 0 0 0 0 0 0 0 0 0 0 0 0 0 0 0 0 8 8 0 0 0 0 0 0 0 0 0 0 0 0 0 0 0 0 0 0 0 0 0 0 0 0 0 0 0 8 8 0 0 0 0 0 0 0 0 0 0 0 0 0 0 0 0 0 
0 0 0 0 0 0 0 0 0 0 0 0 0 0 0 8 8 0 0 0 0 0 0 0 0 0 0 0 0 0 0 0 0 0 8 8 0 0 0 0 0 0 0 0 0 0 0 0 0 0 0 0 8 8 0 0 0 0 0 0 0 0 0 0 0 0 0 0 0 0 0 0 0 0 0 0 0 0 0 0 0 8 8 0 0 0 0 0 0 0 0 0 0 0 0 0 0 0 0 0 
0 0 0 0 1 1 1 1 1 1 1 1 1 1 1 8 8 1 1 3 3 3 1 1 1 1 1 1 1 0 0 0 0 0 8 8 0 0 0 0 0 0 0 0 0 0 0 0 0 0 0 3 3 3 3 0 0 0 0 0 0 0 0 0 0 0 0 0 0 0 0 0 0 0 0 0 0 0 0 0 0 8 8 0 0 0 0 0 0 0 0 0 0 0 0 0 0 0 0 0 
0 0 1 1 1 1 1 1 1 1 1 1 1 1 1 8 8 3 3 3 1 3 3 3 1 1 1 1 1 1 0 0 0 0 8 8 0 0 0 0 0 0 0 0 0 0 3 3 3 3 3 3 3 6 3 3 3 0 0 0 0 0 0 0 0 0 0 0 0 0 0 0 0 0 0 0 0 0 0 0 0 8 8 0 0 0 0 0 0 0 0 0 0 0 0 0 0 0 0 0 
0 1 1 1 1 1 30 1 1 30 1 30 1 1 1 8 8 3 1 1 1 47 1 1 1 1 1 1 1 1 0 0 0 0 8 8 0 0 0 0 0 0 0 0 3 3 3 3 3 3 3 3 3 3 3 3 3 0 3 3 3 0 0 0 3 3 3 0 0 0 0 0 0 0 0 0 0 0 0 0 0 8 8 10 10 10 10 10 10 10 10 10 10 8 8 0 0 0 0 0 
0 1 1 1 1 30 1 1 1 1 30 1 1 1 3 3 3 3 1 47 1 1 1 1 1 1 47 1 1 1 0 0 0 0 8 8 0 0 0 0 0 0 0 3 3 3 3 3 3 3 3 3 3 3 3 3 6 3 3 3 3 0 0 3 3 0 3 0 0 0 0 0 0 0 0 0 0 0 0 0 0 8 8 10 10 10 10 10 10 10 10 10 10 8 8 0 0 0 0 0 
0 1 1 30 1 1 1 1 47 1 1 1 1 1 1 47 1 1 1 1 1 1 1 1 1 1 1 1 1 0 1 0 0 0 8 8 0 0 0 0 0 0 0 3 3 3 3 3 3 6 3 3 3 3 3 3 3 3 3 3 0 0 0 3 0 0 3 0 0 0 0 0 0 0 0 0 0 0 0 0 0 8 8 0 0 3 3 3 3 3 3 3 0 8 8 0 0 0 0 0 
0 1 1 1 47 1 1 1 1 1 1 1 47 1 1 1 1 1 9 0 47 1 1 1 1 47 1 1 1 1 1 0 0 0 8 8 0 0 0 0 0 0 3 3 3 3 3 3 3 3 3 3 3 3 3 3 3 3 3 3 3 3 0 3 0 0 3 0 0 0 0 0 0 0 0 0 0 0 0 0 0 8 8 0 0 1 1 1 1 1 1 3 0 8 8 0 0 0 0 0 
1 30 1 1 1 1 1 1 9 1 1 1 1 1 1 1 1 9 9 9 1 47 1 1 1 47 1 1 1 1 1 0 0 0 8 8 0 0 0 0 0 3 3 3 3 3 3 3 3 3 2 3 3 3 3 3 3 3 3 0 3 3 3 3 3 0 3 3 10 10 10 45 10 10 10 10 10 10 10 0 0 8 8 0 0 1 30 30 30 31 11 3 0 8 8 0 0 0 0 0 
1 1 1 1 1 1 1 1 1 1 1 9 1 1 1 1 1 1 1 9 1 1 1 1 1 47 1 1 1 1 1 1 0 0 8 8 0 0 0 3 0 3 3 3 3 3 3 3 3 3 3 3 3 3 3 3 3 3 3 3 3 3 3 0 3 3 3 3 10 10 10 10 10 45 10 10 10 10 10 10 10 10 10 10 10 1 35 36 1 1 1 3 0 8 8 0 0 0 0 0 
30 1 1 47 1 1 1 1 1 1 1 1 1 1 47 47 1 1 9 9 1 1 47 1 1 1 1 1 1 1 1 1 1 1 8 8 3 3 3 3 3 3 3 3 3 3 3 3 3 3 3 3 3 3 3 3 3 3 3 0 3 3 3 3 0 0 0 3 3 0 0 0 0 0 0 8 0 0 8 0 3 3 3 3 3 1 34 37 1 1 1 3 10 8 8 10 10 10 10 8 
1 1 1 1 1 9 1 1 9 1 1 1 1 1 47 1 1 1 9 1 1 1 1 1 1 1 1 1 1 1 1 0 0 0 8 8 6 6 10 10 10 10 10 10 10 10 10 10 10 10 10 10 2 10 10 10 10 10 10 10 10 10 10 10 10 10 10 10 10 10 10 10 10 10 10 10 0 0 8 0 3 1 30 30 30 1 1 1 1 1 1 0 0 8 8 0 0 0 0 8 
1 30 1 1 1 1 1 1 1 1 1 1 1 1 1 1 1 1 0 1 1 9 47 1 1 1 1 1 1 1 1 0 0 0 8 8 0 0 3 3 3 3 3 3 3 3 3 3 3 3 3 3 3 3 3 2 3 3 3 3 3 3 3 0 0 0 0 0 3 3 3 0 0 0 0 0 0 0 8 0 3 30 1 48 30 1 1 1 47 46 1 0 0 8 8 0 0 0 0 8 
1 30 30 1 1 1 1 47 1 1 1 1 1 9 1 1 1 1 1 1 1 1 1 9 1 1 1 1 1 1 1 0 0 0 8 8 0 0 0 3 3 3 3 6 3 3 3 3 3 3 3 3 3 3 3 3 3 3 0 0 3 3 3 0 0 0 0 0 0 0 0 0 0 0 0 0 0 0 8 10 10 30 47 30 48 45 1 1 1 1 4 10 10 10 8 0 0 0 0 8 
30 30 1 1 1 1 1 1 1 1 1 1 1 1 1 1 1 1 1 1 1 1 1 1 1 1 1 1 1 1 1 0 0 0 8 8 0 0 0 0 0 0 3 3 3 3 3 3 3 3 3 3 2 3 3 3 3 3 3 0 3 3 3 3 0 0 0 0 0 0 0 0 0 0 0 0 0 0 8 0 3 30 1 1 30 30 1 1 1 1 1 0 0 0 0 0 0 0 0 8 
1 1 1 1 1 1 1 1 1 1 1 1 1 1 1 9 1 1 1 1 1 47 1 1 1 1 1 1 0 0 0 0 0 0 8 8 0 0 0 0 0 0 0 3 3 3 6 3 3 3 2 3 3 3 3 3 3 3 6 3 3 3 0 3 3 0 0 0 0 0 0 0 0 0 0 0 0 0 8 0 3 3 8 3 8 3 3 3 3 3 46 0 0 0 0 0 0 0 0 8 
1 1 1 1 1 47 1 1 1 1 1 1 1 1 1 1 1 1 1 1 47 1 1 1 1 1 1 1 0 0 30 30 30 0 8 8 0 0 0 0 0 0 0 0 0 3 3 3 3 3 3 3 3 3 3 3 3 3 3 3 3 3 3 3 0 0 0 0 0 0 0 0 0 0 0 0 0 0 10 10 10 10 10 10 10 0 0 0 0 0 8 0 0 0 0 0 0 0 0 8 
0 1 1 1 1 1 1 1 1 1 1 47 1 1 1 47 1 1 1 1 1 1 1 1 1 1 1 0 0 30 61 61 61 30 8 8 0 0 0 0 0 0 0 0 0 0 0 3 3 3 3 3 3 3 3 3 6 3 3 3 3 3 3 0 0 0 0 0 0 0 0 0 0 0 0 0 0 0 0 0 0 0 8 8 0 0 0 0 0 0 8 0 0 0 0 0 0 0 0 8 
0 0 1 1 1 1 1 1 1 1 1 1 1 1 1 1 1 1 1 1 1 1 1 1 1 1 0 0 30 61 61 61 61 61 8 8 0 0 0 0 0 0 0 0 0 0 0 0 3 3 3 3 3 3 3 3 3 0 3 3 3 3 3 3 0 0 0 0 0 0 0 0 0 0 0 0 0 0 0 0 0 0 8 8 10 10 10 10 10 10 10 0 0 0 0 0 0 0 0 8 
0 0 0 0 0 1 1 1 1 1 1 1 1 1 1 8 1 1 1 1 1 1 1 1 0 0 0 0 30 61 61 61 61 61 10 10 10 10 10 10 10 10 10 10 10 10 0 0 0 0 3 3 3 3 3 3 3 3 3 3 6 3 3 3 0 0 0 0 0 0 0 0 0 0 0 0 0 0 0 0 0 0 8 46 0 0 0 0 0 0 0 0 0 0 0 0 0 0 0 8 
0 0 0 0 0 0 0 0 0 0 0 0 0 0 0 8 0 0 0 0 0 0 0 0 0 0 0 0 30 61 61 61 61 61 30 30 0 0 0 0 0 0 0 0 8 8 0 0 0 0 0 0 0 0 0 0 0 0 3 3 3 3 0 0 0 0 0 0 0 0 0 0 0 0 0 0 0 0 0 0 0 0 8 8 0 0 0 0 0 0 0 0 0 0 0 0 0 0 0 8 
0 0 0 0 0 0 0 0 0 0 0 0 0 0 0 8 0 0 0 0 0 0 0 0 0 5 5 5 5 61 61 61 61 61 61 5 5 5 5 0 0 0 0 0 8 8 0 0 0 0 0 0 0 0 0 0 0 0 0 0 0 8 0 0 0 0 0 0 0 0 0 0 0 0 0 0 0 0 0 0 0 0 8 8 0 0 0 0 0 0 0 0 0 0 0 0 0 0 0 8 
0 0 0 0 0 0 0 0 0 0 0 0 0 0 0 8 0 0 0 0 0 0 0 0 0 5 1 3 5 61 61 61 61 61 61 30 5 5 5 0 0 0 0 0 8 8 0 0 0 0 0 0 0 0 0 0 0 0 0 0 0 8 0 0 0 0 0 0 0 0 0 0 0 0 0 0 0 0 0 0 0 0 8 8 0 0 0 0 0 0 0 0 0 0 0 0 0 0 0 8 
0 0 0 0 0 0 0 0 0 0 0 0 0 0 0 8 8 0 0 0 0 0 0 0 0 1 1 3 5 61 61 61 61 61 61 1 5 1 1 0 0 0 0 0 6 8 0 0 0 0 0 0 0 0 0 0 0 0 0 0 0 8 0 0 0 0 0 0 0 0 0 0 0 0 0 0 0 0 0 0 0 0 8 8 0 0 0 0 0 0 0 0 0 0 0 0 0 0 0 8 
0 0 0 0 0 0 0 0 0 0 0 0 0 0 0 8 8 0 0 0 0 0 0 0 0 1 1 3 1 30 61 61 61 60 54 55 1 1 5 0 0 0 0 0 8 8 0 0 0 0 0 0 0 0 0 0 0 0 0 0 0 8 0 0 0 0 0 0 0 0 0 0 0 0 0 0 0 0 0 0 0 0 8 8 0 0 0 30 30 30 30 30 30 5 30 30 30 0 0 8 
0 0 0 0 0 0 0 0 0 0 0 0 0 0 0 8 8 0 0 0 0 0 0 0 0 1 1 3 5 1 5 61 61 61 58 59 1 1 1 0 0 0 0 0 8 8 0 0 0 0 0 0 0 0 0 0 0 0 0 0 0 8 0 0 0 0 0 0 0 0 0 0 0 0 0 0 0 0 0 0 0 0 8 8 30 30 30 30 5 30 30 5 30 30 30 30 30 0 0 8 
0 0 0 0 0 0 0 0 0 0 0 0 0 0 0 8 8 0 0 0 0 0 0 0 0 5 1 3 5 5 1 58 59 61 61 61 5 1 1 10 10 10 10 10 10 10 0 0 0 0 0 0 0 0 0 0 0 0 0 0 0 8 0 0 0 0 0 0 0 0 0 0 0 0 0 0 0 0 0 0 0 0 8 8 30 30 30 30 30 30 30 30 30 30 30 28 30 0 0 8 
0 0 0 0 0 0 0 0 0 0 0 0 0 0 0 8 8 0 0 0 0 0 0 0 0 5 1 3 1 1 1 61 61 61 61 61 1 30 1 10 10 10 10 10 10 10 0 0 0 0 0 0 0 0 0 0 0 0 0 0 0 8 0 0 0 0 0 0 0 0 0 0 0 0 0 0 0 0 0 0 0 0 8 8 30 28 28 28 5 30 28 5 30 5 30 30 30 0 0 8 
0 0 0 0 0 0 0 0 0 0 0 0 0 0 0 8 8 0 0 0 0 0 0 0 0 5 1 3 1 1 30 1 1 1 5 1 1 1 17 0 0 0 0 0 0 0 0 0 0 0 0 0 0 0 0 0 0 0 0 0 0 8 0 0 0 0 0 0 0 0 0 0 0 0 0 0 0 0 0 0 0 0 8 8 28 28 28 28 28 30 30 30 30 30 30 30 30 0 0 8 
0 0 0 0 0 0 0 0 0 0 0 0 0 0 0 8 8 0 0 0 0 0 0 0 0 1 1 3 5 5 1 1 5 1 1 4 5 30 30 3 3 3 4 5 3 0 0 0 0 0 0 0 0 0 0 0 0 0 0 0 0 8 0 0 0 0 0 0 0 0 0 0 0 0 0 0 0 0 0 0 8 8 8 28 28 5 28 9 28 5 30 28 30 5 28 28 30 0 0 8 
0 0 0 0 0 0 0 0 0 0 0 0 0 0 0 8 8 0 0 0 0 0 0 0 0 5 1 3 5 30 30 3 3 3 3 3 3 3 3 3 3 3 5 4 3 0 0 0 0 0 0 0 0 0 0 0 0 0 0 0 0 8 0 0 0 0 0 0 0 0 0 0 0 0 0 0 0 0 0 0 8 28 28 28 28 28 28 28 28 30 30 30 9 30 30 28 30 0 0 8 
0 0 0 0 0 0 0 0 0 0 0 0 0 0 0 8 8 0 0 0 0 0 0 0 0 5 5 5 5 5 5 5 5 5 5 5 5 5 5 5 5 5 3 3 3 0 0 0 0 0 0 0 0 0 0 0 0 0 0 0 0 0 10 10 10 10 10 10 10 10 10 10 10 0 0 0 0 0 0 0 8 28 28 28 5 28 28 28 28 30 5 30 30 5 30 30 30 0 0 8 
0 0 0 0 0 0 0 0 0 0 0 0 0 0 0 8 8 0 0 0 0 0 0 0 0 0 0 0 0 0 0 0 0 0 0 0 0 0 0 0 0 0 0 0 0 0 0 0 0 0 0 0 0 0 0 0 0 0 0 0 0 0 0 0 0 0 0 0 0 0 0 0 10 10 0 0 0 0 0 0 8 8 8 8 28 28 9 28 30 30 30 30 30 30 30 28 30 0 0 8 
0 0 0 0 0 0 0 0 0 0 0 0 0 0 0 8 8 0 0 0 0 0 0 0 0 0 0 0 0 0 0 0 0 0 0 0 0 0 0 0 0 0 0 0 0 0 0 0 0 0 0 0 0 0 0 0 0 0 0 0 0 0 0 0 0 0 0 0 0 0 0 0 0 10 10 0 0 0 0 0 0 0 8 8 30 28 28 30 30 30 5 30 5 5 30 30 30 0 0 8 
0 0 0 0 0 0 0 0 0 0 0 0 0 0 0 8 8 10 10 10 10 10 10 10 10 10 10 10 10 10 10 10 10 10 10 10 10 10 10 10 10 10 10 10 10 10 10 10 10 10 10 10 10 10 10 10 10 10 10 10 10 10 10 10 10 10 10 10 10 10 0 0 0 8 0 0 0 0 0 0 0 0 8 8 30 28 30 28 28 30 30 30 30 30 30 30 30 0 0 8 
0 0 0 0 0 0 0 0 0 0 0 0 0 0 0 8 8 10 10 10 10 10 10 10 10 10 10 10 10 10 10 10 10 10 10 10 10 10 10 10 10 10 10 10 10 10 10 10 10 10 10 10 10 10 10 10 10 10 10 10 10 10 10 10 10 10 10 10 10 10 0 0 0 8 0 0 0 0 0 0 0 0 8 8 30 5 30 28 28 30 30 5 30 30 28 28 30 0 0 8 
0 0 0 0 0 0 0 0 0 0 0 0 0 0 0 8 8 0 0 0 0 0 0 0 0 0 0 0 0 0 0 0 0 0 0 0 0 0 0 0 0 0 0 0 0 0 0 0 0 0 0 0 0 0 0 0 0 0 0 0 0 0 0 0 0 0 0 0 8 8 0 0 0 8 0 0 0 0 0 0 0 0 8 8 30 30 30 30 5 30 30 30 30 5 30 30 30 0 0 8 
0 0 0 0 0 0 0 0 0 0 0 0 0 0 0 8 8 0 0 0 0 0 0 0 0 0 0 0 0 0 0 0 0 0 0 0 0 0 0 0 0 0 0 0 0 0 0 0 0 0 0 0 0 0 0 0 0 0 0 0 0 0 0 0 0 0 0 0 8 8 0 0 0 8 0 0 0 0 0 0 0 0 8 8 0 0 0 0 0 0 0 0 0 0 0 0 0 0 0 8 
0 0 0 0 0 0 0 0 0 0 0 0 0 0 0 3 3 3 0 30 30 30 30 30 30 30 30 30 30 30 30 30 30 30 30 30 30 30 30 30 30 30 30 30 30 30 30 30 30 30 30 0 0 0 0 0 0 0 0 0 0 0 0 0 0 0 0 0 8 8 0 0 0 8 0 0 0 0 0 0 0 0 8 8 0 0 0 0 0 0 0 0 0 0 0 0 0 0 0 8 
0 0 0 0 0 0 0 0 0 0 0 0 0 0 3 3 3 3 0 30 30 30 30 30 30 30 30 30 30 30 30 30 30 30 30 30 30 3 30 30 30 30 30 30 30 30 30 30 30 30 30 0 0 0 0 0 0 0 0 0 0 0 0 0 0 0 0 0 8 8 0 0 0 8 0 0 0 0 0 0 0 0 8 8 0 0 0 0 0 0 0 0 0 0 0 0 0 0 0 8 
0 0 0 0 0 0 0 0 0 0 0 0 0 3 3 3 3 3 3 30 30 30 30 30 5 30 30 30 30 30 30 30 30 30 30 30 30 30 30 30 30 30 5 30 30 30 30 30 30 30 30 0 0 0 0 0 0 0 0 0 0 0 0 0 0 0 0 0 8 8 0 0 0 8 0 0 0 0 0 0 0 0 8 8 0 0 0 0 0 0 0 0 0 0 0 0 0 0 0 8 
0 0 0 0 0 0 0 0 0 0 0 0 3 3 3 3 0 3 3 30 30 30 30 30 30 30 5 30 30 30 30 30 30 30 30 30 30 30 30 30 30 30 30 30 5 5 30 30 30 30 30 0 0 0 0 0 0 0 0 0 0 0 0 0 0 0 0 0 8 8 0 0 0 8 0 0 0 0 0 0 0 0 8 8 0 0 0 0 0 0 0 0 0 0 0 0 0 0 0 8 
0 0 0 0 0 0 0 0 0 0 0 3 3 3 3 3 3 3 3 30 30 30 30 30 30 30 30 5 30 5 30 5 30 30 30 30 30 30 5 30 30 30 30 30 30 30 5 30 30 30 30 0 0 0 3 3 3 3 0 0 0 0 0 0 0 0 0 0 8 8 0 0 0 8 0 0 0 0 0 0 0 0 8 8 0 0 0 0 0 0 0 0 0 0 0 0 0 0 0 8 
0 0 0 0 0 0 0 0 0 0 0 3 0 3 3 3 3 3 3 30 30 5 30 30 30 30 30 30 30 30 30 30 30 30 30 30 30 30 30 30 30 30 30 30 30 30 30 30 30 30 30 0 0 0 3 3 3 3 3 0 0 0 0 0 0 0 0 0 8 8 0 0 0 8 0 0 0 0 0 0 0 0 8 8 0 0 0 0 0 0 0 0 0 0 0 0 0 0 0 8 
0 0 0 0 0 0 0 0 0 0 0 3 3 3 3 3 0 3 3 30 5 30 30 30 30 30 30 30 30 30 30 5 5 5 5 5 30 30 30 5 30 30 30 30 30 30 30 30 30 30 30 0 0 0 3 3 3 3 3 0 30 30 9 30 28 30 5 0 8 8 0 0 0 8 0 0 0 0 0 0 0 0 8 8 0 0 0 0 0 0 0 0 0 0 0 0 0 0 0 8 
0 0 0 0 0 0 0 0 0 0 0 3 3 3 3 3 3 0 3 30 30 30 30 5 30 30 30 5 5 5 5 5 5 30 30 5 30 30 30 30 30 30 30 30 30 30 5 30 30 30 30 0 0 3 3 3 3 3 3 0 30 30 30 30 30 30 30 0 8 8 0 0 0 8 0 0 0 0 0 0 0 0 8 8 0 0 0 0 0 0 0 0 3 3 3 3 0 0 0 8 
0 0 0 0 0 0 0 0 0 0 0 3 3 3 0 3 3 3 3 30 30 30 3 30 30 30 30 5 30 30 30 30 5 30 30 30 30 30 5 30 5 30 30 30 30 30 30 30 30 30 30 0 0 3 3 3 3 3 3 0 28 30 5 9 30 30 5 0 8 8 0 0 0 8 1 1 1 1 1 1 1 0 8 8 0 1 1 1 1 1 1 3 3 3 3 3 3 0 0 8 
0 0 0 0 0 0 0 0 0 0 0 3 3 3 3 3 3 3 0 30 30 30 30 5 30 30 30 5 30 30 30 30 30 30 30 30 30 30 30 30 30 30 30 30 30 5 30 30 30 30 30 3 3 3 3 3 3 3 3 3 30 9 30 30 30 9 30 10 10 10 10 10 10 8 30 30 30 30 1 1 1 30 8 8 30 30 30 30 5 1 1 3 3 46 3 3 3 3 0 8 
6 6 6 6 6 6 0 0 0 0 0 3 3 3 3 0 3 3 3 30 30 30 30 30 30 30 30 30 30 30 30 30 30 30 30 30 5 30 30 30 30 5 30 30 30 30 30 30 30 30 30 3 3 3 3 3 3 3 3 3 30 30 30 30 9 30 30 0 0 0 0 0 0 8 30 30 30 1 30 30 30 30 8 8 30 30 5 1 30 30 1 3 3 3 3 3 3 3 3 8 
6 0 0 0 0 6 0 0 0 0 0 3 0 3 3 3 3 3 3 30 30 30 30 30 30 5 30 30 30 30 30 30 30 30 30 30 30 5 30 30 30 30 30 30 30 30 30 30 30 30 30 0 0 3 3 3 3 3 3 0 30 5 9 30 30 30 30 0 0 0 0 0 0 8 30 30 30 5 30 5 1 30 8 8 30 30 1 30 30 1 1 3 3 3 3 3 46 3 3 8 
6 0 23 22 0 6 0 0 0 0 0 0 3 3 3 3 3 3 3 30 30 30 30 30 30 30 30 30 30 30 5 5 3 30 30 30 30 30 5 30 30 30 30 30 30 30 30 30 5 30 30 0 3 3 3 3 3 3 3 0 0 3 0 3 3 8 0 0 0 0 0 0 0 8 30 30 30 1 30 30 30 30 8 8 30 5 1 30 1 28 1 3 3 3 3 3 3 3 3 8 
6 0 21 20 0 6 0 0 0 0 0 0 0 0 3 3 3 3 0 30 30 5 30 30 30 30 5 30 30 30 30 30 30 30 30 30 5 30 30 30 30 30 5 30 5 30 30 30 30 30 5 0 3 3 3 3 3 3 3 3 3 0 3 3 3 8 0 0 0 0 0 0 0 8 1 5 1 30 30 10 10 10 8 8 30 30 30 1 28 30 1 3 3 3 46 3 3 3 3 8 
6 6 3 6 6 6 0 0 0 0 0 0 0 0 0 0 0 0 0 30 30 30 30 30 30 30 30 5 30 3 30 30 30 3 30 30 5 30 30 30 30 30 30 30 30 30 30 30 30 30 30 0 0 3 3 3 3 3 3 0 0 3 3 3 3 8 0 0 0 0 0 0 0 8 30 30 1 5 30 8 30 30 30 30 5 1 30 28 1 30 1 3 3 3 3 3 3 3 3 8 
0 0 3 0 0 0 0 0 0 0 0 0 0 0 0 0 0 0 0 30 30 30 30 30 30 30 30 30 30 30 30 30 30 30 30 30 5 30 30 3 30 30 30 30 5 30 30 30 30 30 30 0 0 3 3 3 3 3 3 3 3 3 3 3 3 8 10 0 0 0 0 0 0 8 30 30 30 30 30 8 30 30 30 30 30 30 30 28 1 30 1 3 3 3 3 3 3 3 3 8 
0 0 3 0 0 0 0 0 0 0 0 0 0 0 0 0 0 0 0 30 30 30 30 30 5 30 30 30 30 30 5 30 5 30 5 30 30 30 30 30 5 30 30 30 30 30 30 30 30 30 30 0 0 0 3 3 3 3 3 3 3 3 3 3 3 3 8 0 0 0 0 0 0 8 30 5 1 30 30 8 30 30 30 38 40 43 30 30 30 30 1 3 3 3 3 3 3 3 0 8 
0 0 3 3 3 3 3 3 3 3 3 3 3 3 3 3 3 3 3 30 30 5 30 30 30 30 30 30 30 30 30 30 30 30 30 30 30 30 30 30 30 30 30 30 30 30 30 30 30 30 30 0 0 0 0 3 3 3 3 3 3 3 3 3 3 3 8 0 0 0 0 0 0 8 30 30 30 30 30 8 30 30 30 41 44 42 30 30 30 30 1 3 3 3 3 3 3 0 0 8 
0 0 3 3 3 3 3 3 3 3 3 3 3 3 3 3 3 3 3 0 0 0 0 0 0 0 0 0 0 0 0 0 0 0 0 0 0 0 0 0 0 0 0 0 0 0 0 0 0 0 0 0 0 0 0 0 0 3 3 3 3 3 3 3 3 3 8 0 0 0 0 0 0 8 8 0 0 0 0 8 0 0 0 0 8 0 0 0 0 0 0 0 3 3 3 3 0 0 0 8 
0 0 0 0 0 0 0 0 0 0 0 0 0 0 0 0 0 0 0 0 0 0 0 0 0 0 0 0 0 0 0 0 0 0 0 0 0 0 0 0 0 0 0 0 0 0 0 0 0 0 0 0 0 0 0 0 0 0 0 0 3 3 3 3 0 0 8 0 0 0 0 0 0 8 10 10 10 10 10 10 10 10 10 10 8 0 0 0 0 0 0 0 0 0 0 0 0 0 0 8 
0 0 0 0 0 0 0 0 0 0 0 0 0 0 0 0 0 0 0 0 0 0 0 0 0 0 0 0 0 0 0 0 0 0 0 0 0 0 0 0 0 0 0 0 0 0 0 0 0 0 0 0 0 0 0 0 0 0 0 0 0 0 0 0 0 0 8 0 0 0 0 0 0 0 0 0 0 0 0 0 0 0 0 0 8 0 0 0 0 0 0 0 0 0 0 0 0 0 0 8 
0 0 0 0 0 0 0 0 0 0 0 0 0 0 0 0 0 0 0 0 0 0 0 0 0 0 0 0 0 0 0 0 0 0 0 0 0 0 0 0 0 0 0 0 0 0 0 0 0 0 0 0 0 0 0 0 0 0 0 0 0 0 0 0 0 0 8 0 0 0 0 0 0 0 0 0 0 0 0 0 0 0 0 0 8 10 10 10 10 10 10 10 10 10 10 10 10 10 10 10 
0 0 0 0 0 0 0 0 0 0 0 0 0 0 0 0 0 0 0 0 0 0 0 0 0 0 0 0 0 0 0 0 0 0 0 0 0 0 0 0 0 0 0 0 0 0 0 0 0 0 0 0 0 0 0 0 0 0 0 0 0 0 0 0 0 0 8 10 10 10 10 10 10 10 10 10 10 10 10 10 10 10 10 10 8 0 0 0 0 0 0 0 0 0 0 0 0 0 0 0 
0 0 0 0 0 0 0 0 0 0 0 0 0 0 0 0 0 0 0 0 0 0 0 0 0 0 0 0 0 0 0 0 0 0 0 0 0 0 0 0 0 0 0 0 0 0 0 0 0 0 0 0 0 0 0 0 0 0 0 0 0 0 0 0 0 0 0 0 0 0 0 0 0 0 0 0 0 0 0 0 0 0 0 0 0 0 0 0 0 0 0 0 0 0 0 0 0 0 0 0 
0 0 0 0 0 0 0 0 0 0 0 0 0 0 0 0 0 0 0 0 0 0 0 0 0 0 0 0 0 0 0 0 0 0 0 0 0 0 0 0 0 0 0 0 0 0 0 0 0 0 0 0 0 0 0 0 0 0 0 0 0 0 0 0 0 0 0 0 0 0 0 0 0 0 0 0 0 0 0 0 0 0 0 0 0 0 0 0 0 0 0 0 0 0 0 0 0 0 0 0 
0 0 0 0 0 0 0 0 0 0 0 0 0 0 0 0 0 0 0 0 0 0 0 0 0 0 0 0 0 0 0 0 0 0 0 0 0 0 0 0 0 0 0 0 0 0 0 0 0 0 0 0 0 0 0 0 0 0 0 0 0 0 0 0 0 0 0 0 0 0 0 0 0 0 0 0 0 0 0 0 0 0 0 0 0 0 0 0 0 0 0 0 0 0 0 0 0 0 0 0 
0 0 0 0 0 0 0 0 0 0 0 0 0 0 0 0 0 0 0 0 0 0 0 0 0 0 0 0 0 0 0 0 0 0 0 0 0 0 0 0 0 0 0 0 0 0 0 0 0 0 0 0 0 0 0 0 0 0 0 0 0 0 0 0 0 0 0 0 0 0 0 0 0 0 0 0 0 0 0 0 0 0 0 0 0 0 0 0 0 0 0 0 0 0 0 0 0 0 0 0 
0 0 0 0 0 0 0 0 0 0 0 0 0 0 0 0 0 0 0 0 0 0 0 0 0 0 0 0 0 0 0 0 0 0 0 0 0 0 0 0 0 0 0 0 0 0 0 0 0 0 0 0 0 0 0 0 0 0 0 0 0 0 0 0 0 0 0 0 0 0 0 0 0 0 0 0 0 0 0 0 0 0 0 0 0 0 0 0 0 0 0 0 0 0 0 0 0 0 0 0 
