19 19 19 19 19 19 19 19 19 19 19 19 19 19 19 19 19 19 19 19 19 19 19 19 19 19 19 19 19 19 19 19 19 19 19 19 19 19 19 19 19 19 19 19 19 19 19 19 19 19 
19 19 19 19 19 19 19 19 19 19 19 19 19 19 19 19 19 19 19 19 19 19 19 19 19 19 19 19 19 19 19 19 19 19 19 19 19 19 19 19 19 19 19 19 19 19 19 19 19 19 
19 19 19 19 16 16 16 16 16 16 16 16 16 16 16 16 16 16 16 16 16 16 16 16 16 16 16 16 16 16 16 16 16 16 16 16 16 16 16 16 16 16 16 16 16 16 16 19 19 19 
19 19 19 19 16 1 1 1 1 1 1 1 8 3 3 3 3 3 3 3 3 3 3 3 3 3 3 3 3 3 3 3 3 3 3 3 3 3 3 3 3 3 7 1 1 1 16 19 19 19 
19 19 19 19 16 1 1 1 1 1 1 1 8 3 4 5 5 5 5 5 5 5 5 5 5 5 5 5 5 5 5 5 5 5 5 5 5 5 5 5 6 3 7 1 1 1 16 19 19 19 
19 19 19 19 16 1 1 1 1 1 1 1 8 3 7 2 16 2 16 2 16 1 16 1 16 1 16 1 16 1 16 2 16 1 1 2 1 1 2 1 8 3 7 1 1 1 16 19 19 19 
19 19 19 19 16 1 1 1 1 1 1 1 8 3 7 16 1 16 2 16 2 16 2 16 1 16 1 16 1 16 1 16 1 16 1 1 1 1 1 1 11 3 9 1 1 1 16 19 19 19 
19 19 19 19 16 1 1 1 1 1 1 1 8 3 7 1 16 1 1 1 1 2 2 1 1 1 1 1 1 1 1 1 16 1 1 1 1 1 1 8 3 3 3 7 1 1 16 19 19 19 
19 19 19 19 16 1 1 1 1 1 1 1 8 3 7 16 1 20 21 21 21 21 21 21 21 21 21 21 21 21 22 1 1 16 2 1 1 1 1 8 3 33 3 7 1 1 16 19 19 19 
19 19 19 19 16 1 1 1 1 1 1 1 8 3 7 1 16 23 18 18 18 18 18 18 18 18 18 18 18 18 24 1 16 1 1 1 1 1 1 8 3 3 3 7 1 1 16 19 19 19 
19 19 19 19 16 1 1 1 1 1 1 1 8 3 7 16 1 23 18 18 18 18 18 18 18 18 18 18 18 18 24 1 1 16 1 1 2 1 1 1 6 3 4 2 1 1 16 19 19 19 
19 19 19 19 16 1 1 1 1 1 1 1 8 3 7 1 16 23 18 18 18 18 18 18 18 18 18 18 18 18 24 1 16 1 1 1 1 1 1 1 8 3 7 1 1 1 16 19 19 19 
19 19 19 19 16 1 1 1 1 1 1 1 8 3 7 16 1 23 18 18 18 18 18 18 18 18 28 29 18 18 24 1 1 16 1 1 1 1 1 1 8 3 7 1 1 1 16 19 19 19 
19 19 19 19 16 1 1 1 1 1 1 1 11 3 9 1 16 23 18 18 18 18 18 18 18 18 30 31 18 18 24 1 16 1 1 1 1 1 1 1 8 3 7 1 1 1 16 19 19 19 
19 19 19 19 16 1 1 1 1 1 1 8 3 3 3 7 1 23 18 18 18 18 18 18 18 18 18 18 18 18 24 1 1 16 1 1 1 2 1 1 8 3 7 1 1 1 16 19 19 19 
19 19 19 19 16 1 1 1 1 1 1 8 3 33 3 7 1 23 18 18 18 18 18 18 18 18 18 18 18 18 24 1 16 2 1 1 1 1 1 1 8 3 7 1 1 1 16 19 19 19 
19 19 19 19 16 1 1 1 1 1 1 8 3 3 3 7 1 23 18 18 18 18 18 18 18 18 18 18 18 18 24 1 1 16 1 1 1 1 1 1 8 3 7 1 1 1 16 19 19 19 
19 19 19 19 16 1 1 1 1 1 1 1 6 3 4 2 16 23 18 18 18 18 18 18 18 18 18 18 18 18 24 1 16 1 10 10 10 1 1 1 8 3 7 1 1 1 16 19 19 19 
19 19 19 19 16 1 1 1 1 1 1 1 8 3 7 16 1 23 18 18 18 18 18 18 18 18 18 18 18 18 24 1 1 8 3 3 3 7 1 1 8 3 7 1 1 1 16 19 19 19 
19 19 19 19 16 1 1 1 1 1 1 1 8 3 7 1 16 23 18 18 18 18 18 28 29 18 18 18 18 18 24 1 1 8 3 33 3 7 1 1 8 3 7 1 1 1 16 19 19 19 
19 19 19 19 16 1 1 1 1 1 1 1 8 3 7 16 1 23 18 18 18 18 18 30 31 18 18 18 18 18 24 1 1 8 3 3 3 7 1 1 8 3 7 1 1 1 16 19 19 19 
19 19 19 19 16 1 1 1 1 1 1 1 8 3 7 1 16 23 18 18 18 18 18 18 18 18 18 18 18 18 24 1 1 1 6 3 4 1 1 1 8 3 7 1 1 1 16 19 19 19 
19 19 19 19 16 1 1 1 1 1 1 1 8 3 7 16 1 23 18 18 18 18 18 18 18 28 29 18 18 18 24 1 16 1 8 3 7 1 1 1 8 3 7 1 1 1 16 19 19 19 
19 19 19 19 16 1 1 1 1 1 1 1 8 3 7 1 16 23 18 18 18 18 18 18 18 30 31 18 18 18 24 1 1 16 8 3 7 1 1 1 8 3 7 1 1 1 16 19 19 19 
19 19 19 19 16 1 1 1 1 1 1 1 8 3 7 16 1 23 18 18 18 18 18 18 18 18 18 18 18 18 24 1 16 1 8 3 7 1 1 1 8 3 7 1 1 1 16 19 19 19 
19 19 19 19 16 1 10 10 10 1 1 1 8 3 7 1 16 23 18 18 18 18 18 18 18 18 18 18 18 18 24 1 1 16 8 3 7 1 1 1 8 3 7 1 2 1 16 19 19 19 
19 19 19 19 16 8 3 3 3 7 1 1 8 3 7 16 1 25 26 26 26 26 26 26 26 26 26 26 26 26 27 1 16 1 8 3 7 1 1 1 8 3 7 1 2 1 16 19 19 19 
19 19 19 19 16 8 3 33 3 7 1 1 8 3 7 1 16 1 1 1 1 1 1 1 1 1 1 1 1 1 1 16 1 16 8 3 9 10 10 10 11 3 9 10 10 1 16 19 19 19 
19 19 19 19 16 8 3 3 3 7 1 1 8 3 7 16 1 16 1 12 13 1 16 1 16 1 16 1 16 1 16 1 16 1 8 3 3 3 3 3 3 3 3 3 3 7 16 19 19 19 
19 19 19 19 16 1 6 3 3 9 1 1 8 3 7 1 16 1 16 14 15 16 1 16 1 16 1 16 1 16 1 16 1 16 1 5 5 5 5 5 5 5 5 5 5 1 16 19 19 19 
19 19 19 19 16 1 8 3 3 3 3 3 3 3 7 1 1 1 1 1 1 1 1 1 1 10 10 10 1 1 1 1 1 1 1 1 1 1 1 1 1 1 1 1 1 1 16 19 19 19 
19 19 19 16 16 1 8 3 4 1 1 1 8 3 7 1 1 1 1 1 1 1 1 1 8 3 3 3 7 1 1 1 1 1 1 1 1 1 1 1 1 1 1 1 1 1 16 19 19 19 
19 19 19 16 1 1 8 3 7 1 1 1 8 3 7 1 1 1 1 1 1 1 1 1 8 3 33 3 7 1 1 1 1 1 1 1 1 1 1 1 1 1 1 1 1 1 16 19 19 19 
19 19 19 16 1 1 8 3 7 1 1 1 8 3 9 10 10 10 10 10 10 10 10 10 11 3 3 3 9 10 10 10 10 10 10 10 10 10 10 10 10 1 1 1 1 1 16 19 19 19 
19 19 19 16 1 1 8 3 7 1 1 1 8 3 3 3 3 3 3 3 3 3 3 3 3 3 3 3 3 3 3 3 3 3 3 3 3 3 3 3 3 7 1 1 1 1 16 19 19 19 
19 19 19 16 1 1 8 3 9 10 10 10 2 5 5 5 5 5 5 5 5 5 6 3 3 3 4 5 5 5 5 5 5 5 5 5 5 5 5 6 3 7 1 1 1 1 16 19 19 19 
19 19 19 16 1 1 8 3 3 3 3 3 7 1 1 1 1 1 1 1 1 1 8 3 3 3 7 1 1 1 1 1 16 16 16 16 1 1 1 8 3 7 1 1 1 1 16 19 19 19 
19 19 19 16 1 1 1 5 5 5 6 3 7 1 1 1 1 1 1 1 1 1 8 3 3 3 7 1 1 1 1 16 16 16 16 16 16 1 1 8 3 7 1 1 1 1 16 19 19 19 
19 19 19 16 1 1 1 1 1 1 11 3 9 1 1 1 12 13 1 1 1 1 8 3 3 3 7 1 1 1 1 16 16 12 13 16 16 1 1 8 3 7 1 1 1 1 16 19 19 19 
19 19 19 16 1 1 1 1 1 8 3 3 3 7 1 1 14 15 1 1 1 1 8 3 3 3 7 1 1 1 1 16 16 14 15 16 16 1 1 8 3 7 1 1 1 1 16 19 19 19 
19 19 19 16 1 1 1 1 1 8 3 33 3 7 1 1 1 1 1 1 1 1 8 3 3 3 7 1 1 1 1 16 16 16 16 16 16 1 1 11 3 9 1 1 1 1 16 19 19 19 
19 19 19 16 1 1 1 1 1 8 3 3 3 9 10 10 10 10 10 10 10 10 11 3 3 3 7 1 1 1 1 1 16 16 16 16 1 1 8 3 33 3 7 1 1 1 16 19 19 19 
19 19 19 16 1 1 1 1 1 1 6 3 3 3 3 3 3 3 3 3 3 3 3 3 3 3 7 1 1 1 1 1 1 1 1 1 1 1 8 3 3 3 7 1 1 1 16 19 19 19 
19 19 19 16 1 1 1 1 1 1 1 5 5 5 5 5 5 5 5 5 5 5 6 3 3 3 7 1 1 1 1 1 1 1 1 1 1 1 1 5 5 5 1 1 1 1 16 19 19 19 
19 19 19 16 1 1 1 1 1 1 1 1 1 1 1 1 1 1 1 1 1 1 8 3 3 3 7 1 1 1 1 1 1 1 1 1 1 1 1 1 1 1 1 1 1 1 16 19 19 19 
19 19 19 16 1 1 1 1 1 1 1 1 1 1 1 1 16 16 16 16 16 16 8 3 3 3 7 16 16 16 16 16 16 1 1 1 1 1 1 1 1 1 1 1 1 1 16 19 19 19 
19 19 19 16 1 1 1 1 1 1 1 1 1 1 1 1 16 32 32 32 32 32 32 5 5 5 32 32 32 32 32 32 16 1 1 1 1 1 1 1 1 1 1 1 1 1 16 19 19 19 
19 19 19 16 16 16 16 16 16 16 16 16 16 16 16 16 16 32 32 32 32 32 32 1 2 1 32 32 32 32 32 32 16 16 16 16 16 16 16 16 16 16 16 16 16 16 16 19 19 19 
19 19 19 19 19 19 19 19 19 19 19 19 19 19 19 19 19 19 19 19 19 19 19 19 19 19 19 19 19 19 19 19 19 19 19 19 19 19 19 19 19 19 19 19 19 19 19 19 19 19 
19 19 19 19 19 19 19 19 19 19 19 19 19 19 19 19 19 19 19 19 19 19 19 19 19 19 19 19 19 19 19 19 19 19 19 19 19 19 19 19 19 19 19 19 19 19 19 19 19 19 
