2 2 2 2 2 2 2 2 2 2 2 2 2 2 2 2 2 2
5 5 3 3 3 3 3 3 3 3 3 3 3 3 3 3 4 0
5 5 0 0 0 0 0 0 0 0 0 0 0 0 0 0 4 0
5 5 0 1 1 1 1 1 1 1 1 1 1 1 1 0 4 0
5 5 0 1 1 1 1 1 1 1 1 1 1 1 1 0 4 0
5 5 0 1 1 1 1 1 1 1 1 1 1 1 1 0 4 0
5 5 0 1 1 1 1 1 1 1 1 1 1 1 1 0 4 0 
5 5 0 0 0 0 0 0 0 0 0 0 0 0 0 0 4 0
5 5 0 1 1 1 1 1 1 1 1 1 1 1 1 0 4 0
5 5 0 1 1 1 1 1 1 1 1 1 1 1 1 0 4 0
5 5 0 1 1 1 1 1 1 1 1 1 1 1 1 0 4 0
5 5 0 1 1 1 1 1 1 1 1 1 1 1 1 0 4 0 
5 5 0 0 0 0 0 0 0 0 0 0 0 0 0 0 4 0 
2 2 2 2 2 2 2 2 2 2 2 2 2 2 2 2 2 2 